30 11
******************************
*S                     *******
******* ************** *    G*
*       *            * * *****
******************** * *   * *
*                    * * * * *
* ****************** * * *** *
* *                    *     *
* ************************** *
*                            *
******************************